NO ./textures/wall_north.xpm
SO ./textures/wall_south.xpm
WE ./textures/wall_west.xpm
EA ./textures/wall_east.xpm

CO ./textures/coin1.xpm ./textures/coin2.xpm ./textures/coin3.xpm ./textures/coin4.xpm ./textures/coin5.xpm ./textures/coin6.xpm

DO ./textures/door1.xpm ./textures/door2.xpm ./textures/door3.xpm ./textures/door4.xpm ./textures/door5.xpm ./textures/door6.xpm ./textures/door7.xpm ./textures/door8.xpm ./textures/door9.xpm ./textures/door10.xpm

C 157,217,208
F 255,255,255

        11111 11111111111111111111
    111110C01 100C1100000000000001111
    1C0000101112111100000000000000001
    111110000000000000000000000001111
111111111011000C011100000000000001
10C0000000010010111101111010111111
11110011110111001100000010001
  1101   1001100010101001000111
111001   10C01001100C00100000001
10000111100000001100000010001101
100000000000000N11010100111000C01
1101010111010101111101111  11111
  11C111 1110101 10111101111
   11111 1111111 111111111111
                        11