NO ./textures/wall_north.xpm
SO ./textures/wall_south.xpm
WE ./textures/wall_west.xpm
EA ./textures/wall_east.xpm

CO ./textures/coin1.xpm ./textures/coin2.xpm ./textures/coin3.xpm ./textures/coin4.xpm ./textures/coin5.xpm ./textures/coin6.xpm
DO ./textures/door1.xpm ./textures/door2.xpm ./textures/door3.xpm ./textures/door4.xpm ./textures/door5.xpm ./textures/door6.xpm ./textures/door7.xpm ./textures/door8.xpm ./textures/door9.xpm ./textures/door10.xpm

C 157,217,208
F 255,255,255

1111111
10S01
10001
100031
100011
1C001
10001
10001
10001
100C1
10001
10001
10001
10C01
10001
10001
10001
1C001
10001
10001
10001
10001
10001
10001
10C01
10001
10001
1C001
10001
10001
10001
10001
10C01
10001
10001
10001
1C001
10001
10001
10001
10001
10001
10001
10C01
10001
10001
1C001
10001
10001
10001
10001
10C01
10001
10001
10001
1C001
10001
10001
10001
10001
10001
10001
10C01
10001
10001
1C001
10001
10001
10001
10001
10C01
10001
10001
10001
1C001
10001
10001
10001
10001
10001
10001
10C01
10001
10001
1C001
10001
10001
10001
10001
10C01
10001
10001
10001
1C001
10001
10001
10001
10001
10001
10001
10C01
10001
10001
1C001
10001
10001
10001
10001
10C01
10001
10001
10001
1C001
10001
10001
10001
10001
10001
10001
10C01
10001
10001
1C001
10001
10001
10001
10001
10001
10001
10C01
10001
10001
11211
10001
1C0C1
10001
10C01
10001
1C0C1
11111
