NO ./textures/0.xpm
SO ./textures/1.xpm
WE ./textures/2.xpm
EA ./textures/3.xpm

C 219,216,190
F 186,194,214

11111111111111111
100000111
10S011
10001
100011
100001
10001
10001
100011
10001
100011
10001
100011
10001
100011
10001
100011
10001
100011
10001
100011
10001
100011
10001
100011
10001
100011
100011
10001
100011
10001
100011
10001
100011
10001
100011
111111

